       8        4 
       1        9 
       5        6 
       7        2 
       3        0 
