       3        5 
       7        9 
       1        2 
       6        4 
       8        0 
