       8       11 
       6        5 
       3        4 
      10        1 
       7        2 
       9        0 
