       1        5 
       3        8 
       9        4 
       0        6 
       0        7 
       0        2 
       0       10 
