      13        1 
       8        6 
      10        3 
       5        4 
      11        7 
      12        9 
       0        2 
       0       14 
