       7        5 
       6        4 
       2       11 
      10        1 
       8        9 
       3        0 
