       1        2 
       6        8 
       4        5 
       3        9 
       0        7 
