      14       15 
       9        8 
       7        5 
      11        2 
       1        4 
      12       10 
       0        6 
       0        3 
       0       13 
