      12       13 
       5        3 
       4        8 
       6        7 
      11       10 
       2        1 
       9        0 
